###############
#             #
# ### ### ### #
# ### ### ### #
#             #
# ### ### ### #
#     # #     # 
##### # # #####
      # #      
##### # # #####
#     # #     #
# ### ### ### #
#             #
# ### ### ### #
# ### ### ### #
#             #
###############